 _____________________________________________
|.'',                                     ,''.|
|.'.'',                                 ,''.'.|
|.'.'.'',                             ,''.'.'.|
|.'.'.'.'',_________________________,''.'.'.'.|
|.'.'.'.'.|?????????????????????????|.'.'.'.'.|
|.'.'.'.'.|?????????????????????????|.'.'.'.'.|
|.'.'.'.'.|?????????????????????????|.'.'.'.'.|
|.'.'.'.'.|?????????????????????????|.'.'.'.'.|
|.'.'.'.'.|?????????????????????????|.'.'.'.'.|
|,',',',',|?????????????????????????|,',',',',|
|.'.'.'.'.|?????????????????????????|.'.'.'.'.|
|.'.'.'.'.|?????????????????????????|.'.'.'.'.|
|.'.'.'.'.|?????????????????????????|.'.'.'.'.|
|.'.'.'.'.|_________________________|.'.'.'.'.|
|.'.'.'.','                         ','.'.'.'.|
|.'.'.','                             ','.'.'.|
|.'.','                                 ','.'.|
|.','                                     ','.|
|;___________________________________________;|